449, 91
988, 138, 303
389, 423, 7, 190
353, 58, 810, 44, 847
535, 182, 783, 361, 814, 952
42, 227, 92, 504, 834, 288, 484
868, 428, 182, 35, 186, 151, 178, 632
381, 395, 135, 416, 428, 696, 729, 762, 960
636, 437, 56, 149, 100, 431, 692, 477, 356, 307
991, 453, 71, 85, 345, 821, 557, 938, 865, 172, 287
708, 446, 547, 249, 17, 519, 595, 751, 450, 188, 724, 536